20 10
....................
....................
...@................
..........*.........
..#.................
..#.....#...........
..####..............
.....#.....x........
..####..............
..#.................
